easy
150
....................
.w.--------------.w.
...--------------...
.------------------.
.------------------.
.------------------.
.------------------.
.------------------.
.------------------.
.------------------.
.--------p---------.
.------------------.
.------------------.
.------------------.
.------------------.
.------------------.
.------------------.
...--------------...
.w.--------------.w.
....................