easy
150
..-------.w..-----.w
.w-------...------..
..---..------------.
------.....---------
----------.---------
----------.---------
w..-----.w.---------
..------...---------
--------------------
---------------...--
---------------.w...
---------------.----
---------------.....
-------------------.
-------------------.
.w..---------..w----
...-----------..----
---------------.----
--------------..----
p-------------.w---.