easy
380
.................www
...................w
.................www
...................w
.................www
...................w
.................www
...................w
.................www
...................w
.................www
...................w
.................www
...................w
.................www
...................w
.................www
...................w
.................www
p..................w
