hard
1000
---------g----------
--------w.w---------
--------w.w---------
--------w.w---------
--------w.w---------
--------w.w---------
--------w.w---------
--------w.w---------
--------w.w---------
---------x----------
--------w.w---------
--------w.w---------
--------w.w---------
--------w.w---------
--------w.w---------
--------w.w---------
--------w.w---------
--------w.w---------
--------w.w---------
---------p----------