easy
200
....................
.ww-------------.ww.
.ww-------------.ww.
.---------------....
.------------------.
.------------------.
.------------------.
.------------------.
.------------------.
.------------------.
.--------p---------.
.------------------.
.------------------.
.------------------.
.------------------.
.------------------.
....------------....
.ww.------------.ww.
.ww.------------.ww.
....................