easy
1000
--------------------
--------------------
--------------------
--------------------
--------------------
--------------------
--------------------
---wwwwwww----------
---w.....w----------
---w.....w----------
---wwwwwgw----------
--------.-----------
--------.-----------
--------.-----------
--------.-----------
--------.-----------
--------.-----------
--------.-----------
--------.-----------
p.......x-----------