easy
1000
....................
.------------------.
.------------------.
.------------------.
.----..........----.
.----.--------.----.
.----.--------.----.
.----.---x----.----.
.----.---.----.----.
.----.---.----.----.
.----.---.----.----.
.----.---.----.----.
.----.---.----.----.
.----.....----.----.
.-------------.----.
.-------------.----.
...............----.
-------------------.
-------------------.
p...................