hard
100
--------------------
--------------------
--------------------
--------------------
--------------------
--------------------
--------------------
--------------------
--------------------
--------------------
--------------------
----------.---------
---------w.---------
---------w.---------
---------w.---------
------wwww.---------
---------w.---------
----------.---------
--------ww.---------
p..........--------g