hard
30
--------------------
--------------------
--------------------
--------------------
--------------------
--------------------
--------------------
--------------------
--------------------
--------------------
--------------------
--------------------
--------------------
--------------------
--------------------
---g----------------
-........x..--------
-.wwww.wwww.--------
-......w....--------
p..---...-----------