hard
1000
--------------------
--------------------
--------------------
--------------------
--------------------
--------------------
--------------------
--------------------
--------------------
--------------------
--------------------
--------------------
wwwwwwwww-----------
........w-----------
.wwwwww.w--------www
.w--wwwxw--------w.w
.w--w...w--------w.w
.wwwwxw.wwwwwwwwww.w
p.....g............w
wwwwwwwwwwwwwwwwwwww