easy
1000
.........w..........
.-------...--------.
.------------------.
.------------------.
.------------------.
.------------------.
.------------------.
.------------------.
.-----------------..
..----------------.w
w.----------------..
..-----------------.
.------------------.
.------------------.
.------------------.
.------------------.
.------------------.
.------------------.
.--------...-------.
p.........w.........