easy
1000
--------------------
--------------------
--------------------
--------------------
-...............----
-.-------------.----
-.-------------.----
-.-------------.----
-.-----.........----
-------.------------
........------------
.-------------------
.-------------------
.-------------------
.-------------------
.-------------------
.-------------------
...-----------------
--.-----------------
p..-----------------