hard
1000
--------------------
--------------------
--------------------
--------------------
--------------------
--------------------
--------------------
--------------------
--------------------
-----------g--------
------..w..---------
------..w..---------
------wwwww---------
------..w..---------
------..w..---------
-----p--------------
--------------------
--------------------
--------------------
--------------------